1111111111111111111111111111111111111111
100000000101000000000000100T000090000001
1000000001010000000000001000000000000001
1000000001111111000111111000000000000001
1000000000000001000100000000000T00000001
1000000000000001000100000000000000000001
1000000000000001000I00000000000000000001
1000000000000001000100000000000000000001
1000000000000001000000000000000000000001
1000000040000001000100000000000000000001
1000000000000001000100000000000000000001
1000000000011111000100000000000000000001
1000000000000000000100000000000000000001
1000000000000001000000000000000000000001
1000000000000000000000000000000000000001
1000000000000000000000000000000000000001
1000000000000000000000000000000000000001
1000000000000000000000000000000000000001
1000000000000000000000000000000000000001
1000000000000000000000000000000000000001
1000000000000000000000000000000000000001
1000000000000000000000000000000000000001
1000000000000000000000000000000000000001
1000000000000000000000000000000000000001
1000000000000000000000000000000000000001
1000000000000000000000000000000000000001
1000000000000000000000000000000000000001
1000000000000000000000000000000000000001
1000000000000000000000000000000000000001
1000000000000000000000000000000000000001
1000000000000000000000000000000000000001
1000000000000000000000000000000000000001
1000000000000000000000000000000000000001
1000000000000000000000000000000000000001
1000000000000000000000000000000000000001
1000000000000000000000000000000000000001
1000000000000000000000000000000000000001
1000000000000000000000000000000000000001
1000000000000000000000000000000000000001
1111111111111111111111111111111111111111
